Rk,Player,Pos,Age,Tm,G,GS,MP,FG,FGA,FG%,3P,3PA,3P%,2P,2PA,2P%,FT,FTA,FT%,ORB,DRB,TRB,AST,STL,BLK,TOV,PF,PTS
1,Precious Achiuwa,PF,21,MIA,35,2,491,84,145,0.579,0,0,,84,145,0.579,44,81,0.5429999999999999,46,95,141,20,15,19,32,58,212
2,Jaylen Adams,PG,24,MIL,7,0,18,1,8,0.125,0,2,0.0,1,6,0.16699999999999998,0,0,,0,3,3,2,0,0,0,1,20000
3,Steven Adams,C,27,NOP,33,33,918,115,187,0.615,0,1,0.0,115,186,0.618,35,79,0.44299999999999995,133,161,294,69,29,20,50,63,265
4,Bam Adebayo,C,23,MIA,33,33,1119,236,419,0.563,2,6,0.05,234,413,0.5670000000000001,160,189,0.847,72,241,313,179,29,34,98,80,634
5,LaMarcus Aldridge,C,35,SAS ,21,18,544,115,248,0.46399999999999997,27,75,0.36,88,173,0.509,31,37,0.838,17,77,94,36,8,18,20,36,28800
6,Ty-Shon Alexander,SG,22, PHO,3,0,8,0,3,0.0,0,1,0.0,0,2,0.0,0,0,,0,1,1,1,0,0,0,1,0
7,Nickeil Alexander-Walker,SG ,22,NOP,28,3,495,86,211,0.408,30,98,0.306,56,113,0.496,28,35,0.8,5,61,66,54,28,9,32,44,230
8,Grayson Allen,SG,25,MEM,23,12,551,67,164,0.409,46,113,0.40700000000000003,21,51,0.41200000000000003,34,38,0.895,8,57,65,50,23,3,21,30,214
9,Jarrett Allen,C,22, TOT,35,17,977,172,257,0.669,4,8,0.05,168,249,0.675,123,166,0.741,111,235,346,60,16,59,54,55,471
9,Jarrett Allen,C,22,BRK ,12,5,320,44,65,0.677,0,0,,44,65,0.677,46,61,0.754,38,87,125,20,7,19,22,21,134
9,Jarrett Allen,C,22,CLE,23,12,657,128,192,0.667,4,8,0.5,124,184,0.674,77,105,0.733,73,148,221,40,9,40,32,34,337
10,Al-Farouq Aminu,PF,30,ORL,9,6,163,17,43,0.395,6,15,0.4,11,28,0.39299999999999996,7,9,0.778,9,28,37,15,8,5,10,9,47
11,Kyle Anderson,PF,27,MEM,30,30,829,146,306,0.47700000000000004,46,121,0.38,100,185,0.541,64,84,0.762,28,155,183,105,36,21,46,54,402
12,Giannis Antetokounmpo,PF,26,MIL,35,35,1189,368,661,0.557,39,137,0.285,329,524,0.628,240,363,0.6609999999999999,64,344,408,205,44,49,128,106,1015
13,Kostas Antetokounmpo,PF,23,LAL,3,0,19,1,3,0.33299999999999996,0,0,,1,3,0.33299999999999996,1,2,0.5,2,6,8,0,1,2,5,3,3
14,Thanasis Antetokounmpo,SF,28,MIL,26,0,227,26,43,0.605,2,9,0.222,24,34,0.706,6,13,0.462,26,29,55,18,8,6,19,33,60
15,Carmelo Anthony,PF,36,POR,34,3,870,166,402,0.413,60,155,0.387,106,247,0.429,80,95,0.8420000000000001,19,94,113,50,31,27,35,72,472
16,Cole Anthony,PG,20,ORL,25,17,667,101,269,0.375,27,83,0.325,74,186,0.39799999999999996,46,55,0.836,20,91,111,94,17,11,51,51,275
17,OG Anunoby,SF,23,TOR,23,23,769,114,238,0.479,49,124,0.395,65,114,0.57,40,53,0.755,33,99,132,38,37,17,38,64,317
18,Ryan Arcidiacono,PG,26,CHI,18,0,198,21,50,0.42,11,32,0.344,10,18,0.556,8,9,0.889,2,31,33,23,5,0,4,16,61
19,D.J. Augustin,PG,33,MIL,34,6,664,64,183,0.35,45,123,0.366,19,60,0.317,35,39,0.897,11,35,46,103,19,1,30,27,208
20,Deni Avdija,SF,20,WAS,30,16,646,68,157,0.433,31,87,0.35600000000000004,37,70,0.529,11,19,0.579,13,127,140,39,20,6,24,75,178
21,Deandre Ayton,C,22,PHO,35,35,1088,218,367,0.594,4,17,0.235,214,350,0.611,66,88,0.75,118,282,400,59,11,38,61,110,506
22,Udoka Azubuike,C,21,UTA,12,0,49,4,7,0.5710000000000001,0,0,,4,7,0.5710000000000001,4,6,0.667,4,9,13,0,1,4,3,8,12
23,Dwayne Bacon,SG,25,ORL,36,23,886,136,329,0.413,34,102,0.33299999999999996,102,227,0.449,57,69,0.826,12,91,103,35,23,3,26,57,363
24,Marvin Bagley III,PF,21,SAC,34,34,888,195,390,0.5,34,92,0.73,161,298,0.54,54,102,0.529,83,175,258,33,18,16,47,82,478
25,LaMelo Ball,PG,19,CHO,35,15,1010,201,448,0.449,70,185,0.37799999999999995,131,263,0.498,81,101,0.802,51,160,211,221,57,13,99,95,553
26,Lonzo Ball,PG,23,NOP,33,33,1048,175,409,0.428,99,256,0.387,76,153,0.49700000000000005,31,40,0.775,20,117,137,168,43,18,66,71,480
27,Mo Bamba,C,22,ORL,17,0,161,35,67,0.522,7,19,0.368,28,48,0.583,4,6,0.667,19,46,65,4,3,13,7,21,81
28,Desmond Bane,SG,22,MEM,28,6,639,100,209,0.478,47,106,0.44299999999999995,53,103,0.515,21,24,0.875,12,68,80,38,20,4,29,54,268
29,Harrison Barnes,PF,28,SAC,33,33,1179,184,374,0.49200000000000005,56,143,0.392,128,231,0.5539999999999999,128,155,0.826,33,167,200,118,26,6,47,43,552
30,RJ Barrett,SG,20,NYK,37,37,1227,233,526,0.44299999999999995,43,123,0.35,190,403,0.47100000000000003,103,141,0.73,45,176,221,109,24,8,70,96,612
31,Will Barton,SF,30,DEN,33,29,986,148,335,0.442,50,129,0.38799999999999996,98,206,0.47600000000000003,37,49,0.755,19,116,135,102,25,14,55,54,383
32,Keita Bates-Diop,SF,25,SAS,13,0,107,11,31,0.355,5,14,0.35700000000000004,6,17,0.353,7,8,0.875,5,14,19,7,6,1,1,5,34
33,Nicolas Batum,SF,32,LAC,35,35,1031,108,229,0.47200000000000003,68,155,0.439,40,74,0.541,30,36,0.833,30,137,167,84,42,13,26,59,314
34,Aron Baynes,C,34,TOR,33,26,649,88,200,0.44,17,70,0.243,71,130,0.546,15,20,0.75,54,125,179,35,10,11,30,80,208
35,Kent Bazemore,SF,31,GSW,35,1,587,84,175,0.48,39,89,0.43799999999999994,45,86,0.523,24,32,0.75,14,91,105,56,30,19,38,77,231
36,Darius Bazley,PF,20,OKC,36,36,1104,158,403,0.392,54,186,0.29,104,217,0.479,57,81,0.7040000000000001,22,248,270,54,18,23,63,31,427
37,Bradley Beal,SGa,27,WAS,32,32,1143,368,764,0.48200000000000004,74,221,0.335,294,543,0.541,243,269,0.903,43,131,174,151,44,14,105,82,1053
38,Malik Beasley,SG,24,MIN,33,32,1093,250,550,0.455,116,286,0.406,134,264,0.508,61,72,0.847,27,126,153,81,27,6,54,54,677
39,Jordan Bell,C,26,WAS,3,1,50,5,15,0.33299999999999996,0,2,0.0,5,13,0.385,0,0,,5,11,16,5,1,3,3,4,10
40,DeAndre' Bembry,SF,26,TOR,27,5,443,49,86,0.57,8,22,0.364,41,64,0.6409999999999999,14,20,0.7,11,43,54,53,15,8,27,44,120
41,Dāvis Bertāns,PF,28,WAS,30,3,783,100,258,0.38799999999999996,88,229,0.384,12,29,0.414,58,68,0.853,14,80,94,28,19,7,18,75,346
42,Patrick Beverley,PG,32,LAC,28,28,678,79,177,0.446,49,116,0.42200000000000004,30,61,0.49200000000000005,31,39,0.795,27,80,107,60,25,22,27,90,238
43,Saddiq Bey,SF,21,DET,34,17,778,108,264,0.409,72,183,0.39299999999999996,36,81,0.444,48,56,0.857,18,115,133,39,21,1,23,54,336
44,Tyler Bey,SF,22,DAL,4,0,13,2,5,0.4,0,0,,2,5,0.4,2,4,0.5,2,1,3,0,0,1,0,2,6
45,Khem Birch,C,28,ORL,35,1,703,76,153,0.49700000000000005,4,13,0.308,72,140,0.514,51,69,0.7390000000000001,90,97,187,37,21,25,19,54,207
46,Goga Bitadze,C,21,IND,16,0,148,24,47,0.511,2,15,0.133,22,32,0.688,10,13,0.769,11,21,32,4,3,15,8,26,60
47,Bismack Biyombo,C,28,CHO,33,19,736,78,137,0.569,0,1,0.0,78,136,0.574,29,60,0.483,71,113,184,48,9,38,30,81,185
48,Nemanja Bjelica,PF,32,SAC,19,1,342,58,120,0.483,15,45,0.33299999999999996,43,75,0.573,30,38,0.789,20,60,80,42,6,2,24,36,161
49,Eric Bledsoe,SG,31,NOP,35,34,1038,158,363,0.435,69,179,0.385,89,184,0.484,55,81,0.679,16,108,124,134,28,10,56,54,440
50,Keljin Blevins,SF,25,POR,9,0,47,2,11,0.182,0,4,0.0,2,7,0.28600000000000003,0,0,,0,2,2,4,2,0,3,4,4
51,Bogdan Bogdanović,SG,28,ATL,11,2,249,35,91,0.385,23,67,0.34299999999999997,12,24,0.5,10,11,0.909,2,36,38,24,4,2,13,21,103
52,Bojan Bogdanović,SF,31,UTA,36,36,1102,188,435,0.43200000000000005,98,242,0.405,90,193,0.466,92,108,0.852,18,122,140,70,18,2,51,59,566
53,Bol Bol,PF,21,DEN,15,2,84,11,22,0.5,5,10,0.5,6,12,0.5,1,2,0.5,0,11,11,4,2,5,8,9,28
54,Marques Bolden,C,22,CLE,6,0,29,1,3,0.33299999999999996,0,0,,1,3,0.33299999999999996,5,8,0.625,3,3,6,0,2,2,2,0,7
55,Jordan Bone,PG,23,ORL,14,0,196,23,54,0.426,10,32,0.313,13,22,0.591,0,0,,4,20,24,18,2,0,3,11,56
56,Isaac Bonga,SF,21,WAS,22,7,271,17,45,0.37799999999999995,10,29,0.345,7,16,0.43799999999999994,3,4,0.75,9,35,44,13,6,5,9,33,47
57,Devin Booker,SG,24,PHO,31,31,1050,284,573,0.496,63,174,0.36200000000000004,221,399,0.5539999999999999,141,168,0.8390000000000001,6,107,113,137,28,8,103,93,772
58,Chris Boucher,C,28,TOR,36,2,851,172,322,0.534,61,137,0.445,111,185,0.6,85,112,0.759,67,167,234,36,20,69,26,98,490
59,Brian Bowen,SF.,22,IND,1,0,5,1,2,0.5,0,0,,1,2,0.5,1,1,1.0,0,1,1,0,0,0,0,0,3
60,Avery Bradley,SG,30,MIA,10,1,211,31,66,0.47,16,38,0.42100000000000004,15,28,0.536,7,9,0.778,2,16,18,14,7,1,9,26,85
61,Tony Bradley,C,23,PHI,12,1,127,22,39,0.564,0,1,0.0,22,38,0.579,3,5,0.6,21,29,50,6,3,7,1,11,47
62,Jarrell Brantley,PF,24,UTA,10,0,28,4,10,0.4,3,7,0.429,1,3,0.33299999999999996,0,0,,2,5,7,0,1,1,1,4,11
63,Ignas Brazdeikis,SF,22,NYK,4,0,7,0,1,0.0,0,0,,0,1,0.0,2,2,1.0,1,1,2,1,0,0,1,0,2
64,Mikal Bridges,SF,24,PHO,35,35,1131,172,328,0.524,66,157,0.42,106,171,0.62,69,82,0.841,47,130,177,77,25,33,27,56,479
65,Miles Bridges,PFa,22,CHO,35,2,937,132,269,0.491,46,120,0.38299999999999995,86,149,0.5770000000000001,41,44,0.932,45,155,200,73,25,25,60,83,351
66,Malcolm Brogdon,PG,28,IND,34,34,1211,276,617,0.447,82,217,0.37799999999999995,194,400,0.485,87,97,0.897,27,131,158,212,40,8,71,64,721
67,Dillon Brooks,SF,25,MEM,29,29,846,176,444,0.396,54,169,0.32,122,275,0.444,55,66,0.833,28,63,91,76,41,14,59,95,461
68,Bruce Brown,PG,24,BRK,33,20,698,118,200,0.59,9,33,0.273,109,167,0.653,38,53,0.7170000000000001,51,103,154,46,26,10,26,69,283
69,Jaylen Brown,SG,24,BOS,33,33,1115,305,616,0.495,76,196,0.38799999999999996,229,420,0.545,129,167,0.772,37,147,184,129,36,16,93,96,815
70,Moses Brown,C,21,OKC,7,0,31,7,10,0.7,0,0,,7,10,0.7,7,14,0.5,4,11,15,3,1,4,1,4,21
71,Sterling Brown,SG,25,HOU,32,2,713,86,196,0.439,51,127,0.402,35,69,0.507,14,15,0.9329999999999999,22,112,134,55,31,7,25,64,237
72,Troy Brown Jr.,SF,21,WAS,17,0,231,26,71,0.366,11,38,0.289,15,33,0.455,7,12,0.583,8,43,51,13,2,2,12,25,70
73,Jalen Brunson,PG,24,DAL,30,7,748,139,262,0.531,39,97,0.402,100,165,0.606,64,75,0.853,6,99,105,101,16,0,38,45,381
74,Thomas Bryant,C,23,WAS,10,10,271,59,91,0.648,9,21,0.429,50,70,0.7140000000000001,16,24,0.667,18,43,61,15,4,8,11,31,143
75,Reggie Bullock,SF,29,NYK,32,32,841,99,244,0.406,55,148,0.37200000000000005,44,96,0.45799999999999996,20,24,0.833,10,99,109,42,20,7,23,69,273
76,Trey Burke,PG,28,DAL,33,0,537,92,205,0.449,41,104,0.39399999999999996,51,101,0.505,27,31,0.871,4,30,34,53,22,2,19,41,252
77,Alec Burks,SG,29,NYK,25,3,617,92,227,0.405,47,117,0.402,45,110,0.409,47,56,0.8390000000000001,12,96,108,51,18,5,27,48,278
78,Jimmy Butler,SF,31,MIA,22,22,729,143,315,0.45399999999999996,8,34,0.235,135,281,0.48,158,183,0.863,44,122,166,172,42,8,51,26,452
79,Bruno Caboclo,PF,25,HOU,6,0,36,8,17,0.47100000000000003,0,5,0.0,8,12,0.667,1,2,0.5,3,11,14,1,0,2,4,6,17
80,Devontae Cacok,PF,24,LAL,4,0,17,4,4,1.0,0,0,,4,4,1.0,0,2,0.0,1,4,5,0,2,0,2,0,8
81,Kentavious Caldwell-Pope,SG,27,LAL,33,33,863,98,224,0.43799999999999994,51,127,0.402,47,97,0.485,39,46,0.848,15,63,78,47,26,9,34,55,286
82,Facundo Campazzo,PG,29,DEN,30,1,488,51,126,0.405,33,87,0.379,18,39,0.462,30,37,0.8109999999999999,5,26,31,62,29,7,25,57,165
83,Vlatko Čančar,PF,23,DEN,20,0,122,11,28,0.39299999999999996,3,14,0.214,8,14,0.5710000000000001,5,6,0.833,4,23,27,6,7,2,9,11,30
84,Clint Capela,C,26,ATL,32,32,949,208,353,0.589,0,0,,208,353,0.589,55,100,0.55,159,294,453,29,24,71,46,73,471
85,Vernon Carey Jr.,C,19,CHO,3,0,6,1,3,0.33299999999999996,0,1,0.0,1,2,0.5,1,2,0.5,2,1,3,1,0,1,0,0,3
86,Jevon Carter,PG,25,PHO,29,0,289,30,84,0.35700000000000004,17,57,0.298,13,27,0.48100000000000004,2,2,1.0,3,34,37,35,13,7,5,31,79
87,Wendell Carter Jr.,C,21,CHI,23,23,618,106,198,0.535,7,20,0.35,99,178,0.556,63,86,0.733,48,131,179,52,16,19,43,74,282
88,Michael Carter-Williams,SG,29,ORL,17,12,450,58,144,0.40299999999999997,8,31,0.258,50,113,0.442,29,38,0.763,27,55,82,70,10,9,32,50,153
89,Alex Caruso,PG,26,LAL,29,0,577,62,145,0.428,28,70,0.4,34,75,0.45299999999999996,16,23,0.696,17,63,80,70,30,6,32,51,168
90,Willie Cauley-Stein,C,27,DAL,31,10,537,70,112,0.625,1,6,0.16699999999999998,69,106,0.6509999999999999,31,48,0.6459999999999999,39,101,140,24,10,23,16,73,172
91,Chris Chiozza,PG,25,BRK,15,0,136,17,47,0.36200000000000004,9,23,0.391,8,24,0.33299999999999996,10,13,0.769,3,13,16,36,4,4,10,11,53
92,Marquese Chriss,PF,23,GSW,2,0,27,5,14,0.35700000000000004,1,5,0.2,4,9,0.444,2,4,0.5,3,10,13,2,0,2,2,3,13
93,Gary Clark,SF,26,ORL,30,11,572,33,112,0.295,26,95,0.27399999999999997,7,17,0.41200000000000003,8,9,0.889,29,66,95,25,11,6,15,31,100
94,Brandon Clarke,PF,24,MEM,27,16,726,140,272,0.515,15,46,0.326,125,226,0.5529999999999999,35,53,0.66,44,111,155,43,33,17,16,43,330
95,Jordan Clarkson,SG,28,UTA,36,0,937,237,530,0.447,114,308,0.37,123,222,0.5539999999999999,58,60,0.9670000000000001,31,113,144,82,34,7,62,54,646
96,Nicolas Claxton,C,21,BRK,5,0,76,20,29,0.69,0,1,0.0,20,28,0.7140000000000001,10,14,0.7140000000000001,4,13,17,5,5,7,2,8,50
97,Amir Coffey,SG,23,LAC,20,0,154,21,40,0.525,11,21,0.524,10,19,0.526,3,9,0.33299999999999996,3,12,15,8,4,0,8,11,56
98,John Collins,PF,23,ATL,36,36,1104,252,470,0.536,50,129,0.38799999999999996,202,341,0.5920000000000001,93,109,0.853,76,198,274,52,16,35,48,118,647
99,Mike Conley,PG,33,UTA,29,29,853,161,363,0.444,81,192,0.42200000000000004,80,171,0.46799999999999997,63,76,0.8290000000000001,28,73,101,164,42,3,54,56,466
100,Pat Connaughton,SG,28,MIL,33,0,697,78,176,0.44299999999999995,46,117,0.39299999999999996,32,59,0.542,14,17,0.8240000000000001,31,110,141,46,22,15,12,52,216
101,Quinn Cook,PG,27,LAL,16,0,62,12,26,0.462,5,13,0.385,7,13,0.5379999999999999,4,5,0.8,0,5,5,5,1,1,3,2,33
102,Tyler Cook,PF ,23,BRK,4,0,17,1,3,0.33299999999999996,0,0,,1,3,0.33299999999999996,0,0,,1,1,2,2,0,0,1,2,2
103,DeMarcus Cousins,C,30,HOU,25,11,506,79,210,0.376,39,116,0.336,40,94,0.426,44,59,0.746,30,161,191,60,21,18,39,74,241
104,Robert Covington,PF,30,POR,33,33,1054,91,243,0.374,57,171,0.33299999999999996,34,72,0.47200000000000003,23,28,0.821,27,191,218,55,53,39,40,85,262
105,Torrey Craig,SF,30,MIL,17,0,194,17,43,0.395,8,21,0.381,9,22,0.409,1,2,0.5,13,29,42,13,9,6,5,23,43
106,Jae Crowder,PF,30,PHO,32,19,883,109,271,0.402,77,205,0.376,32,66,0.485,29,35,0.8290000000000001,13,147,160,68,27,8,29,58,324
107,Jarrett Culver,SG,21,MIN,19,7,376,54,128,0.42200000000000004,8,35,0.22899999999999998,46,93,0.495,21,35,0.6,30,60,90,16,12,7,23,40,137
108,Seth Curry,SG,30,PHI,28,28,836,123,262,0.469,56,125,0.44799999999999995,67,137,0.489,48,52,0.9229999999999999,5,51,56,77,25,8,41,48,350
109,Stephen Curry,PG,32,GSW,35,35,1194,343,718,0.478,169,411,0.41100000000000003,174,307,0.5670000000000001,184,197,0.934,17,174,191,221,46,2,111,64,1039
110,Anthony Davis,PF,27,LAL,23,23,755,204,383,0.5329999999999999,17,58,0.293,187,325,0.575,93,130,0.715,47,146,193,70,31,41,45,42,518
111,Ed Davis,C,31,MIN,19,7,264,18,43,0.419,0,0,,18,43,0.419,7,8,0.875,38,59,97,19,10,10,6,49,43
112,Terence Davis,SG,23,TOR,30,3,442,79,187,0.42200000000000004,40,110,0.364,39,77,0.506,16,18,0.889,9,49,58,32,16,6,24,46,214
113,DeMar DeRozan,PF,31,SAS,29,29,981,194,401,0.484,16,52,0.308,178,349,0.51,175,196,0.893,22,120,142,209,25,8,49,55,579
114,Hamidou Diallo,SG,22,OKC ,32,5,761,143,297,0.48100000000000004,12,41,0.293,131,256,0.512,83,132,0.629,37,128,165,77,31,12,49,83,381
115,Gorgui Dieng,C,31,MEM,22,1,371,56,108,0.519,23,48,0.479,33,60,0.55,38,43,0.884,28,70,98,29,17,14,22,38,173
116,Spencer Dinwiddie,SG,27,BRK,3,3,64,6,16,0.375,2,7,0.28600000000000003,4,9,0.444,6,6,1.0,0,13,13,9,2,1,5,4,20
117,Donte DiVincenzo,SG,24,MIL,36,36,960,140,335,0.418,68,177,0.384,72,158,0.456,21,33,0.636,43,126,169,107,38,8,43,53,369
118,Luka Dončić,PG,21,DAL,32,32,1125,319,668,0.478,85,238,0.35700000000000004,234,430,0.544,193,255,0.757,27,242,269,287,32,22,133,64,916
119,Luguentz Dort,SG ,21,OKC,35,35,1040,149,384,0.38799999999999996,68,209,0.325,81,175,0.46299999999999997,66,88,0.75,24,97,121,51,31,10,52,85,432
120,Damyean Dotson,SG,26,CLE,30,6,565,79,197,0.401,29,104,0.27899999999999997,50,93,0.5379999999999999,18,26,0.6920000000000001,4,49,53,65,12,4,24,26,205
121,Devon Dotson,PG,21,CHI,1,0,10,2,4,0.5,0,0,,2,4,0.5,0,0,,0,1,1,0,0,0,0,1,4
122,Sekou Doumbouya,PF,20,DET,32,2,439,50,141,0.355,15,60,0.25,35,81,0.43200000000000005,19,26,0.731,16,57,73,22,13,2,18,50,134
123,PJ Dozier,SG,24,DEN,21,0,408,58,127,0.457,20,51,0.392,38,76,0.5,23,38,0.605,18,64,82,35,11,13,16,36,159
124,Goran Dragić,PG,34,MIA,22,8,596,116,253,0.45799999999999996,35,97,0.361,81,156,0.519,58,69,0.841,7,61,68,105,13,4,61,58,325
125,Andre Drummond,C,27,CLE,25,25,722,180,380,0.474,0,8,0.0,180,372,0.484,77,129,0.597,101,236,337,64,40,29,81,69,437
126,Jared Dudley,PF,35,LAL,11,0,76,2,7,0.28600000000000003,2,5,0.4,0,2,0.0,0,0,,4,15,19,5,1,1,2,7,6
127,Kevin Durant,PF,32,BRK,19,18,679,188,359,0.524,49,113,0.434,139,246,0.565,126,145,0.8690000000000001,7,132,139,100,14,27,67,43,551
128,Anthony Edwards,SG,19,MIN,36,19,1048,199,537,0.371,68,225,0.302,131,312,0.42,70,87,0.805,26,118,144,90,31,15,66,55,536
129,Carsen Edwards,SG,22,BOS,14,1,147,29,63,0.46,11,34,0.324,18,29,0.621,7,9,0.778,2,12,14,6,4,1,2,16,76
130,CJ Elleby,SF,20,POR,13,0,105,14,31,0.452,5,19,0.263,9,12,0.75,6,9,0.667,4,10,14,3,4,3,3,18,39
131,Wayne Ellington,SG,33,DET,28,24,650,103,227,0.45399999999999996,77,178,0.433,26,49,0.531,20,27,0.741,8,39,47,40,13,6,19,43,303
132,Joel Embiid,C,26,PHI,30,30,990,285,547,0.521,37,89,0.41600000000000004,248,458,0.541,298,348,0.856,65,283,348,98,37,41,96,75,905
133,James Ennis,SF,30,ORL,24,23,514,60,120,0.5,21,47,0.447,39,73,0.534,33,42,0.7859999999999999,26,67,93,32,20,6,21,53,174
134,Drew Eubanks,C,23,SAS,15,0,180,21,51,0.41200000000000003,0,0,,21,51,0.41200000000000003,14,20,0.7,9,37,46,9,1,16,8,19,56
135,Dante Exum,SG,25,CLE,6,3,116,10,26,0.385,2,11,0.182,8,15,0.5329999999999999,1,2,0.5,2,15,17,13,4,2,7,9,23
136,Tacko Fall,C,25,BOS,8,0,57,9,13,0.6920000000000001,0,0,,9,13,0.6920000000000001,3,8,0.375,8,13,21,1,0,10,1,10,21
137,Derrick Favors,C,29,UTA,34,0,550,85,131,0.649,0,1,0.0,85,130,0.654,45,57,0.789,65,122,187,28,18,31,21,83,215
138,Cristiano Felício,C,28,CHI,6,0,38,3,4,0.75,0,0,,3,4,0.75,5,8,0.625,6,6,12,5,2,0,3,3,11
139,Terrance Ferguson,SG,22,PHI,9,0,34,1,5,0.2,0,3,0.0,1,2,0.5,0,0,,0,1,1,2,0,0,3,5,2
140,Bruno Fernando,C ,22,ATL,18,0,151,11,25,0.44,0,2,0.0,11,23,0.478,9,15,0.6,13,47,60,9,2,2,15,17,31
141,Yogi Ferrell, PG,27,CLE,2,0,40,8,21,0.381,3,9,0.33299999999999996,5,12,0.41700000000000004,0,2,0.0,3,4,7,5,3,1,3,4,19
142,Dorian Finney-Smith,PF,27,DAL,25,25,787,77,180,0.428,41,119,0.345,36,61,0.59,10,12,0.833,36,92,128,34,25,10,15,67,205
143,Malachi Flynn,PG,22,TOR,15,0,125,12,45,0.267,5,26,0.192,7,19,0.368,4,6,0.667,1,10,11,16,4,0,4,12,33
144,Bryn Forbes,SG,27,MIL,36,6,675,121,259,0.467,73,163,0.44799999999999995,48,96,0.5,20,27,0.741,7,40,47,21,8,0,19,39,335
145,Trent Forrest,PG,22,UTA,7,0,20,0,3,0.0,0,2,0.0,0,1,0.0,2,2,1.0,0,2,2,4,2,0,1,2,2
146,Evan Fournier,SF,28,ORL,21,21,613,127,282,0.45,52,140,0.371,75,142,0.528,83,105,0.79,5,60,65,79,22,7,45,42,389
147,De'Aaron Fox,PG,23,SAC,35,35,1198,293,629,0.466,64,187,0.342,229,442,0.518,156,232,0.672,23,90,113,265,43,17,115,102,806
148,Tim Frazier,PG,30,MEM,3,0,33,2,8,0.25,0,2,0.0,2,6,0.33299999999999996,0,0,,0,4,4,7,1,0,3,4,4
149,Markelle Fultz,PG,22,ORL,8,8,215,41,104,0.39399999999999996,4,16,0.25,37,88,0.42,17,19,0.895,5,20,25,43,8,2,18,18,103
150,Wenyen Gabriel,PF,23, NOP,4,0,12,0,3,0.0,0,1,0.0,0,2,0.0,0,0,,1,4,5,1,0,0,0,0,0
151,Daniel Gafford,PF,22,CHI,26,11,343,50,75,0.667,0,0,,50,75,0.667,26,39,0.667,34,48,82,16,11,32,19,48,126
152,Danilo Gallinari,PF,32,ATL,24,2,525,81,207,0.391,47,121,0.38799999999999996,34,86,0.395,71,76,0.934,5,76,81,37,13,3,27,46,280
153,Langston Galloway,SG,29,PHO,25,0,262,38,82,0.46299999999999997,21,46,0.457,17,36,0.47200000000000003,16,16,1.0,4,22,26,16,4,0,7,14,113
154,Darius Garland,PG,21,CLE,28,25,922,179,407,0.44,48,125,0.384,131,282,0.465,45,53,0.8490000000000001,13,49,62,164,33,3,82,62,451
155,Marc Gasol,C,36,LAL,35,35,703,54,134,0.40299999999999997,31,85,0.365,23,49,0.469,29,36,0.8059999999999999,25,118,143,69,17,45,30,82,168
156,Rudy Gay,PF,34,SAS,26,0,572,108,258,0.419,41,112,0.366,67,146,0.45899999999999996,33,43,0.767,24,111,135,39,18,13,30,47,290
157,Paul George,SF,30,LAC,27,27,904,225,451,0.499,95,211,0.45,130,240,0.542,95,107,0.888,24,141,165,146,30,14,91,63,640
158,Taj Gibson,PF,35,NYK,12,0,181,18,31,0.581,2,7,0.28600000000000003,16,24,0.667,7,12,0.583,18,33,51,6,5,4,7,23,45
159,Harry Giles,C,22,POR,22,0,260,26,62,0.419,3,8,0.375,23,54,0.426,13,18,0.722,25,83,108,20,5,9,16,44,68
160,Shai Gilgeous-Alexander,SG,22,OKC,30,30,1020,239,468,0.511,61,148,0.41200000000000003,178,320,0.556,158,199,0.794,17,136,153,187,23,20,87,60,697
161,Anthony Gill,PF,280,WAS,12,1,67,3,10,0.3,1,7,0.14300000000000002,2,3,0.667,3,4,0.75,3,16,19,4,3,2,3,3,10
162,Rudy Gobert,C,28,UTA,36,36,1105,196,306,0.6409999999999999,0,1,0.0,196,305,0.643,118,197,0.599,120,352,472,48,17,98,64,82,510
163,Brandon Goodwin,PG,25,ATL,24,0,289,35,106,0.33,15,53,0.28300000000000003,20,53,0.377,17,24,0.708,3,24,27,43,10,0,13,23,102
164,Aaron Gordon,PF,25,ORL,19,19,552,91,213,0.42700000000000005,31,84,0.369,60,129,0.465,49,80,0.613,33,104,137,80,14,16,53,38,262
165,Eric Gordon,SG,32,HOU,26,12,763,153,350,0.43700000000000006,66,201,0.32799999999999996,87,149,0.584,92,110,0.836,7,49,56,70,14,13,50,41,464
166,Devonte' Graham,PG,25,CHO,25,25,821,109,310,0.35200000000000004,70,202,0.34700000000000003,39,108,0.361,55,71,0.775,14,61,75,142,25,0,35,38,343
167,Jerami Grant,SF,26,DET,33,33,1194,254,586,0.433,81,223,0.363,173,363,0.47700000000000004,184,207,0.889,24,152,176,96,25,36,62,90,773
168,Danny Green,SF,33, PHI,36,36,1018,106,270,0.39299999999999996,80,213,0.376,26,57,0.456,13,20,0.65,31,97,128,61,45,28,46,66,305
169,Draymond Green,PF,30,GSW,31,31,918,68,174,0.391,14,59,0.237,54,115,0.47,27,38,0.711,23,165,188,267,44,22,84,100,177
170,JaMychal Green,PF,30,DEN,25,4,512,80,180,0.444,41,96,0.42700000000000005,39,84,0.46399999999999997,27,32,0.8440000000000001,41,109,150,24,15,7,26,68,228
171,Javonte Green,SG,27,BOS,22,2,330,39,71,0.5489999999999999,7,22,0.318,32,49,0.653,20,30,0.667,20,30,50,10,18,2,12,29,105
172,Jeff Green,C,34,BRK,33,16,870,113,223,0.507,49,116,0.42200000000000004,64,107,0.598,39,49,0.7959999999999999,15,103,118,46,23,8,27,62,314
173,Josh Green,SG,20,DAL,17,5,212,17,36,0.47200000000000003,2,12,0.16699999999999998,15,24,0.625,6,11,0.545,12,27,39,10,4,1,11,16,42
174,Blake Griffin,PF,31,DET ,20,20,626,81,222,0.365,39,124,0.315,42,98,0.429,44,62,0.71,7,97,104,77,14,2,32,42,245
175,Kyle Guy,PG,23,SAC,14,0,115,14,44,0.318,6,24,0.25,8,20,0.4,7,8,0.875,3,11,14,15,4,0,3,9,41
176,Rui Hachimura,PF,22,WAS,27,27,813,122,267,0.457,21,69,0.304,101,198,0.51,72,95,0.758,29,118,147,47,19,2,28,61,337
177,Ashton Hagans,PG,21,MIN,2,0,4,0,0,,0,0,,0,0,,0,0,,0,0,0,0,0,0,1,0,0
178,Tyrese Haliburton,PG,20,SAC,30,2,903,153,310,0.494,71,164,0.433,82,146,0.562,20,24,0.833,29,78,107,161,42,18,46,36,397
179,Josh Hall,SF,20,OKC,7,0,51,4,18,0.222,1,8,0.125,3,10,0.3,3,7,0.429,1,8,9,7,0,0,4,7,12
180,R.J. Hampton,PG,19,DEN,24,0,220,24,58,0.414,5,18,0.278,19,40,0.475,7,10,0.7,10,37,47,12,5,2,11,21,60
181,Tim Hardaway Jr.,SG,28,DAL,33,17,975,190,434,0.43799999999999994,97,252,0.385,93,182,0.511,65,81,0.802,12,93,105,56,20,6,30,51,542
182,James Harden,PG-SG ,31,TOT,31,31,1173,250,517,0.484,101,252,0.401,149,265,0.562,183,213,0.8590000000000001,26,216,242,345,36,21,131,67,784
182,James Harden,sg,31,HOU,8,8,290,60,135,0.444,25,72,0.34700000000000003,35,63,0.556,53,60,0.883,5,36,41,83,7,6,34,14,198
182,James Harden,PG,31,BRK,23,23,883,190,382,0.49700000000000005,76,180,0.42200000000000004,114,202,0.564,130,153,0.85,21,180,201,262,29,15,97,53,586
183,Maurice Harkless,SF,27,MIA,10,3,109,4,10,0.4,4,8,0.5,0,2,0.0,0,2,0.0,1,8,9,7,2,3,2,12,12
184,Jared Harper,PG,23,NYK,2,0,5,0,1,0.0,0,0,,0,1,0.0,2,2,1.0,0,0,0,0,0,0,2,0,2
185,Montrezl Harrell,C,27,LAL,37,1,891,209,334,0.626,0,6,0.0,209,328,0.637,93,123,0.7559999999999999,89,149,238,39,24,27,41,77,511
186,Gary Harris,SG,26,DEN,19,19,581,69,156,0.442,24,75,0.32,45,81,0.556,22,30,0.733,13,34,47,32,17,4,14,37,184
187,Jalen Harris,SG,22,TOR,2,0,4,0,0,,0,0,,0,0,,0,0,,1,0,1,0,0,0,1,2,0
188,Joe Harris,SF,29,BRK,37,33,1144,201,379,0.53,126,249,0.506,75,130,0.5770000000000001,21,30,0.7,19,112,131,65,20,7,29,82,549
189,Tobias Harris,PF,28,PHI,31,31,1066,241,470,0.513,51,127,0.402,190,343,0.5539999999999999,94,106,0.887,37,199,236,104,25,26,58,64,627
190,Shaquille Harrison,SG,27,UTA,17,0,56,6,20,0.3,0,2,0.0,6,18,0.33299999999999996,5,6,0.833,3,6,9,9,2,0,5,3,17
191,Josh Hart,SF,25,NOP,36,3,1032,114,255,0.447,49,147,0.33299999999999996,65,108,0.602,53,70,0.757,38,226,264,74,29,9,28,87,330
192,Isaiah Hartenstein,C,22,DEN,26,0,243,39,76,0.513,0,0,,39,76,0.513,20,34,0.588,37,37,74,14,10,15,19,53,98
193,Jaxson Hayes,C,20,NOP,25,1,311,46,68,0.6759999999999999,0,0,,46,68,0.6759999999999999,19,29,0.655,31,58,89,9,9,12,16,45,111
194,Killian Hayes,PG,-19,DET,7,7,148,13,47,0.27699999999999997,5,20,0.25,8,27,0.29600000000000004,1,2,0.5,1,7,8,25,2,0,17,15,32
195,Gordon Hayward,SF,30,CHO,31,31,1080,245,503,0.48700000000000004,64,158,0.405,181,345,0.525,114,133,0.857,27,140,167,121,41,12,62,55,668
196,Juan Hernangómez,PF,25,MIN,17,6,271,36,90,0.4,16,53,0.302,20,37,0.541,13,19,0.684,13,62,75,10,6,2,7,14,101
197,Willy Hernangómez,C,26,NOP,20,2,359,60,110,0.545,1,5,0.2,59,105,0.562,24,36,0.667,53,86,139,26,7,10,11,27,145
198,Tyler Herro,SG,21,MIA,25,14,818,151,345,0.43799999999999994,50,144,0.34700000000000003,101,201,0.502,44,57,0.772,11,132,143,90,15,10,61,40,396
199,Buddy Hield,SG,28,SAC,36,36,1253,198,507,0.391,140,370,0.37799999999999995,58,137,0.423,54,64,0.8440000000000001,12,150,162,114,29,11,64,96,590
200,George Hill,PG,34,OKC,14,14,369,61,120,0.508,22,57,0.386,39,63,0.619,21,25,0.84,8,21,29,43,12,2,12,12,165
201,Solomon Hill,PF,29,ATL,36,1,686,53,149,0.35600000000000004,35,110,0.318,18,39,0.462,15,17,0.882,18,64,82,33,25,6,21,58,156
202,Nate Hinton,SG,21,DAL,6,0,19,3,13,0.231,1,5,0.2,2,8,0.25,1,2,0.5,0,0,0,0,1,1,2,1,8
203,Aaron Holiday,PG,24,IND,35,6,667,95,256,0.371,38,108,0.35200000000000004,57,148,0.385,29,40,0.725,7,39,46,63,20,4,29,62,257
204,Jrue Holiday,PG,30,MIL,26,23,805,159,324,0.491,44,121,0.364,115,203,0.5670000000000001,36,47,0.7659999999999999,31,82,113,133,47,14,42,45,398
205,Justin Holiday,SG,31,IND,35,26,1130,139,303,0.45899999999999996,89,215,0.414,50,88,0.568,41,50,0.82,22,117,139,60,43,14,28,78,408
206,Richaun Holmes,C,27,SAC,32,32,942,179,275,0.6509999999999999,1,6,0.16699999999999998,178,269,0.662,58,72,0.8059999999999999,81,185,266,55,23,48,43,127,417
207,Rodney Hood,SF,28,POR,30,5,575,62,168,0.369,20,67,0.299,42,101,0.41600000000000004,5,8,0.625,8,42,50,32,17,3,25,42,149
208,Al Horford,C,34,OKC,24,24,677,138,312,0.442,47,132,0.35600000000000004,91,180,0.506,14,18,0.778,23,137,160,84,21,21,27,43,337
209,Talen Horton-Tucker,SG,20,LAL,33,1,576,94,213,0.441,18,63,0.28600000000000003,76,150,0.507,32,39,0.821,10,70,80,66,27,19,43,69,238
210,Danuel House,SF,27,HOU,22,12,602,69,184,0.375,34,109,0.312,35,75,0.467,28,37,0.757,16,71,87,42,14,12,21,43,200
211,Dwight Howard,C,35,PHI,36,4,574,81,138,0.5870000000000001,4,11,0.364,77,127,0.606,53,100,0.53,91,173,264,27,15,31,62,105,219
212,Markus Howard,SG,21,DEN,17,0,55,6,31,0.19399999999999998,3,22,0.136,3,9,0.33299999999999996,1,2,0.5,0,5,5,6,2,0,4,7,16
213,Kevin Huerter,SG,22,ATL,36,25,1157,165,387,0.426,77,211,0.365,88,176,0.5,28,34,0.8240000000000001,26,105,131,133,46,7,47,87,435
214,Elijah Hughes,SF,22,UTA,6,0,27,5,15,0.33299999999999996,3,10,0.3,2,5,0.4,3,4,0.75,0,4,4,3,1,1,4,0,16
215,De'Andre Hunter,SF,23,ATL,18,18,579,108,210,0.514,30,82,0.366,78,128,0.609,64,73,0.877,16,81,97,40,17,9,25,47,310
216,Chandler Hutchison,SF,24,CHI,7,0,64,5,18,0.278,1,3,0.33299999999999996,4,15,0.267,2,2,1.0,1,19,20,4,1,0,5,9,13
217,Serge Ibaka,C,31,LAC,37,37,887,169,333,0.508,37,104,0.35600000000000004,132,229,0.5760000000000001,36,44,0.818,62,184,246,66,9,46,42,73,411
218,Andre Iguodala,SF,37,MIA,34,2,735,57,147,0.38799999999999996,38,112,0.33899999999999997,19,35,0.5429999999999999,14,25,0.56,20,106,126,77,36,16,36,51,166
219,Joe Ingles,SF,33,UTA,32,9,846,128,245,0.522,79,170,0.465,49,75,0.653,34,38,0.895,13,94,107,140,15,8,50,56,369
220,Brandon Ingram,SF,23,NOP,36,36,1255,306,648,0.47200000000000003,85,224,0.379,221,424,0.521,164,185,0.8859999999999999,22,163,185,172,25,28,84,71,861
221,Kyrie Irving,PG,28,BRK,26,26,924,269,527,0.51,76,185,0.41100000000000003,193,342,0.564,94,106,0.887,31,93,124,155,28,16,59,74,708
222,Wesley Iwundu,SF,26,DAL,20,3,246,14,47,0.298,3,23,0.13,11,24,0.45799999999999996,9,11,0.818,5,30,35,8,7,3,5,20,40
223,Frank Jackson,PG,22,DET,9,0,54,6,22,0.273,4,13,0.308,2,9,0.222,0,0,,0,8,8,10,1,0,4,5,16
224,Josh Jackson,SG,23,DET,32,6,797,154,362,0.425,41,141,0.29100000000000004,113,221,0.511,84,121,0.6940000000000001,34,107,141,60,29,28,74,94,433
225,Justin Jackson,Sf,25,OKC,25,2,405,61,149,0.409,23,79,0.29100000000000004,38,70,0.5429999999999999,16,20,0.8,11,47,58,38,10,1,24,24,161
226,Reggie Jackson,SG,30,LAC,35,16,709,114,250,0.456,46,115,0.4,68,135,0.504,31,41,0.7559999999999999,13,77,90,103,20,3,35,65,305
227,Justin James,SF,24,SAC,13,0,69,9,23,0.391,2,9,0.222,7,14,0.5,2,8,0.25,3,6,9,5,3,1,2,3,22
228,LeBron James,PG,36,LAL,36,36,1245,350,687,0.509,86,240,0.358,264,447,0.591,144,208,0.6920000000000001,21,268,289,280,41,22,135,56,930
229,DaQuan Jeffries,SG,23,SAC,12,2,189,22,52,0.423,8,24,0.33299999999999996,14,28,0.5,6,7,0.857,7,14,21,4,5,4,5,17,58
230,Ty Jerome,SG,23,OKC,4,0,100,15,30,0.5,7,19,0.368,8,11,0.727,0,0,,3,8,11,13,3,0,2,14,37
231,Isaiah Joe, SG,21, PHI,20,1,240,29,79,0.36700000000000005,23,60,0.38299999999999995,6,19,0.316,5,5,1.0,6,17,23,15,7,4,5,21,86
232,Cameron Johnson,PF,24,PHO,34,9,823,125,286,0.43700000000000006,73,193,0.37799999999999995,52,93,0.5589999999999999,32,37,0.865,19,96,115,46,22,10,26,48,355
233,James Johnson,PF,33,DAL,27,1,484,65,140,0.46399999999999997,15,58,0.259,50,82,0.61,14,26,0.5379999999999999,12,71,83,47,23,22,26,55,159
234,Keldon Johnson,SF,21,SAS,29,27,845,151,320,0.47200000000000003,28,86,0.326,123,234,0.526,79,101,0.782,47,146,193,63,22,14,41,66,409
235,Stanley Johnson,PF,24,TOR,32,2,441,31,79,0.392,20,50,0.4,11,29,0.379,11,14,0.7859999999999999,15,54,69,41,24,9,22,49,93
236,Tyler Johnson,SG,28, BRK,18,1,250,28,72,0.389,21,51,0.41200000000000003,7,21,0.33299999999999996,7,7,1.0,4,27,31,17,6,0,5,13,84
237,Nikola Jokić,C,25,DEN,36,36,1293,379,668,0.5670000000000001,56,134,0.418,323,534,0.605,163,185,0.8809999999999999,101,296,397,309,58,23,114,107,977
238,Damian Jones,C,25,TOT,17,1,125,13,21,0.619,0,1,0.0,13,20,0.65,8,13,0.615,9,14,23,4,1,9,6,25,34
238,Damian Jones,C,25,PHO,14,0,94,8,16,0.5,0,1,0.0,8,15,0.5329999999999999,6,11,0.545,7,11,18,4,1,5,6,19,22
238,Damian Jones,C,25,LAL,3,1,31,5,5,1.0,0,0,,5,5,1.0,2,2,1.0,2,3,5,0,0,4,0,6,12
239,Derrick Jones Jr.,SF,23,POR,31,30,838,92,182,0.505,26,78,0.33299999999999996,66,104,0.635,40,62,0.645,58,91,149,27,24,34,22,74,250
240,Mason Jones,SG,22,HOU,22,1,244,38,87,0.43700000000000006,18,49,0.36700000000000005,20,38,0.526,28,43,0.6509999999999999,4,42,46,29,6,0,26,22,122
241,Tre Jones,PG,21,SAS,12,0,43,9,15,0.6,1,1,1.0,8,14,0.5710000000000001,5,5,1.0,4,0,4,3,0,0,4,4,24
242,Tyus Jones,PG,24,MEM,32,8,691,111,251,0.442,25,85,0.294,86,166,0.518,17,20,0.85,15,66,81,146,40,4,28,14,264
243,DeAndre Jordan,C,32,BRK ,35,26,799,115,151,0.762,0,1,0.0,115,150,0.767,29,56,0.518,63,199,262,67,11,51,59,76,259
244,Cory Joseph,PG,29,SAC,36,2,749,90,201,0.44799999999999995,24,75,0.32,66,126,0.524,27,35,0.7709999999999999,20,58,78,85,24,7,36,83,231
245,Mfiondu Kabengele,PF,23,LAC,20,0,81,7,26,0.26899999999999996,3,15,0.2,4,11,0.364,3,4,0.75,1,10,11,5,2,3,5,14,20
246,Frank Kaminsky,C,27,PHO,27,11,428,77,165,0.467,26,62,0.419,51,103,0.495,17,29,0.586,22,84,106,46,8,12,14,38,197
247,Enes Kanter,C,28,POR,35,23,919,177,298,0.594,0,0,,177,298,0.594,63,84,0.75,146,269,415,40,18,26,41,94,417
248,Luke Kennard,SG,24,LAC,34,7,684,94,203,0.46299999999999997,52,114,0.456,42,89,0.47200000000000003,13,15,0.867,8,82,90,58,11,6,29,54,253
249,Maxi Kleber,PF,29,DAL,22,16,569,48,109,0.44,37,82,0.451,11,27,0.40700000000000003,22,23,0.9570000000000001,19,98,117,30,10,20,12,50,155
250,Nathan Knight,PF,23,ATL,10,0,58,9,23,0.391,3,9,0.33299999999999996,6,14,0.429,7,8,0.875,8,7,15,1,2,3,5,7,28
251,Kevin Knox,SF,21,NYK,26,0,397,47,119,0.395,28,72,0.389,19,47,0.40399999999999997,11,14,0.7859999999999999,9,40,49,17,8,6,16,33,133
252,John Konchar,SG,24,MEM,19,0,308,28,66,0.424,7,23,0.304,21,43,0.488,16,18,0.889,18,50,68,23,18,5,8,26,79
253,Furkan Korkmaz,SG,23, PHI,25,3,467,69,180,0.38299999999999995,39,113,0.345,30,67,0.44799999999999995,24,30,0.8,5,56,61,21,15,4,24,30,201
254,Luke Kornet,PF,25,CHI,10,0,83,9,26,0.34600000000000003,6,22,0.273,3,4,0.75,2,2,1.0,1,14,15,4,2,6,1,1,26
255,Rodions Kurucs,SF-PF,22,TOT,16,0,91,6,24,0.25,3,17,0.17600000000000002,3,7,0.429,1,2,0.5,2,12,14,6,6,4,9,8,16
255,Rodions Kurucs,PF,22,BRK ,5,0,16,1,3,0.33299999999999996,1,2,0.5,0,1,0.0,0,0,,0,3,3,2,0,0,0,1,3
255,Rodions Kurucs,SF,22,HOU,11,0,75,5,21,0.23800000000000002,2,15,0.133,3,6,0.5,1,2,0.5,2,9,11,4,6,4,9,7,13
256,Kyle Kuzma,SF,25,LAL,36,11,932,162,365,0.444,65,178,0.365,97,187,0.519,24,38,0.632,75,165,240,41,14,23,54,63,413
257,Jeremy Lamb,SG,28,IND,21,8,486,78,165,0.473,34,76,0.447,44,89,0.494,48,51,0.941,15,63,78,34,18,11,16,44,238
258,Zach LaVine,SG,25,CHI,34,34,1209,350,667,0.525,120,276,0.435,230,391,0.588,156,182,0.857,25,152,177,173,37,14,133,90,976
259,Jake Layman,SF,26,MIN,24,4,372,59,115,0.513,15,47,0.319,44,68,0.647,21,27,0.778,7,30,37,16,20,11,17,27,154
260,Jalen Lecque,PG,20, IND,3,0,9,1,4,0.25,0,1,0.0,1,3,0.33299999999999996,3,3,1.0,1,3,4,2,0,0,0,0,5
261,Damion Lee,SG,28,GSW,37,1,712,79,177,0.446,52,138,0.377,27,39,0.6920000000000001,28,31,0.903,15,110,125,53,25,4,17,55,238
262,Saben Lee,PG,21,DET,15,0,238,38,70,0.5429999999999999,4,6,0.667,34,64,0.531,26,39,0.667,6,17,23,35,11,5,14,25,106
263,Alex Len,C,27,TOT,26,6,352,54,86,0.628,6,20,0.3,48,66,0.727,24,42,0.5710000000000001,19,62,81,23,9,32,25,47,138
263,Alex Len,C,27,TOR,7,2,76,5,10,0.5,3,6,0.5,2,4,0.5,3,6,0.5,0,11,11,3,1,6,8,10,16
263,Alex Len,C,27,WAS,19,4,276,49,76,0.645,3,14,0.214,46,62,0.742,21,36,0.583,19,51,70,20,8,26,17,37,122
264,Kawhi Leonard,SF,29,LAC,30,30,1039,287,562,0.511,60,155,0.387,227,407,0.5579999999999999,165,189,0.873,28,160,188,146,45,16,58,48,799
265,Meyers Leonard,C,28,MIA,3,2,29,3,7,0.429,3,7,0.429,0,0,,1,2,0.5,0,7,7,2,0,0,2,5,10
266,Caris LeVert,SG,26,BRK,12,4,334,87,200,0.435,22,63,0.349,65,137,0.474,26,34,0.765,10,42,52,72,13,6,26,20,222
267,Kira Lewis Jr.,PG,19,NOP,21,0,273,42,108,0.389,13,39,0.33299999999999996,29,69,0.42,13,20,0.65,2,15,17,38,12,1,9,25,110
268,Damian Lillard,PG,30,POR,34,34,1224,315,708,0.445,146,380,0.384,169,328,0.515,237,254,0.9329999999999999,15,130,145,271,35,9,111,53,1013
269,Nassir Little,PF,20,POR,20,2,239,33,70,0.47100000000000003,17,37,0.45899999999999996,16,33,0.485,22,25,0.88,14,31,45,7,3,5,10,21,105
270,Kevon Looney,C,24,GSW,27,10,401,44,74,0.595,2,6,0.33299999999999996,42,68,0.618,16,21,0.762,48,65,113,43,10,8,17,50,106
271,Brook Lopez,C,32,MIL ,36,36,975,141,302,0.467,55,158,0.348,86,144,0.597,50,61,0.82,49,134,183,22,19,48,32,76,387
272,Robin Lopez,C,32,WAS,34,9,690,112,189,0.593,4,13,0.308,108,176,0.614,53,76,0.6970000000000001,78,66,144,32,10,21,37,65,281
273,Kevin Love,PF,32,CLE,2,2,46,6,18,0.33299999999999996,3,9,0.33299999999999996,3,9,0.33299999999999996,4,5,0.8,2,10,12,5,1,0,3,1,19
274,Kyle Lowry,PG,34,TOR,29,29,1002,174,381,0.457,83,206,0.40299999999999997,91,175,0.52,91,106,0.858,24,136,160,204,34,6,82,94,522
275,Timothé Luwawu-Cabarrot,SF,25,BRK,34,6,669,86,221,0.389,53,146,0.363,33,75,0.44,20,26,0.769,18,62,80,43,24,5,25,63,245
276,Trey Lyles,PF,25, SAS,19,7,311,42,83,0.506,14,37,0.37799999999999995,28,46,0.609,12,19,0.632,8,69,77,11,5,1,3,11,110
277,Thon Maker,C,23,CLE,8,0,76,10,18,0.556,0,2,0.0,10,16,0.625,10,11,0.909,8,10,18,4,2,4,3,7,30
278,Théo Maledon,PG,19,OKC,31,16,797,86,218,0.39399999999999996,45,127,0.354,41,91,0.451,24,32,0.75,7,85,92,102,31,2,56,69,241
279,Karim Mané,PG,20,ORL ,6,0,56,1,9,0.111,1,2,0.5,0,7,0.0,4,4,1.0,0,10,10,1,0,1,3,3,7
280,Terance Mann,SG,24,LAC,35,3,549,62,129,0.48100000000000004,13,34,0.382,49,95,0.516,32,40,0.8,31,83,114,45,14,6,23,59,169
281,Nico Mannion,PG,19,GSW,7,1,67,6,23,0.261,5,14,0.35700000000000004,1,9,0.111,1,4,0.25,0,12,12,18,3,0,7,8,18
282,Boban Marjanović,C,32,DAL,18,1,141,36,72,0.5,0,4,0.0,36,68,0.529,10,14,0.7140000000000001,27,44,71,3,1,1,8,16,82
283,Lauri Markkanen,PF,23,CHI,14,14,426,95,185,0.514,40,101,0.396,55,84,0.655,38,45,0.8440000000000001,8,77,85,12,9,5,24,31,268
284,Naji Marshall,SF,23,NOP,3,0,8,0,2,0.0,0,1,0.0,0,1,0.0,1,2,0.5,0,2,2,1,0,0,0,0,1
285,Caleb Martin,SF,25,CHO,26,1,395,55,133,0.414,19,57,0.33299999999999996,36,76,0.474,14,26,0.5379999999999999,20,53,73,30,21,7,17,26,143
286,Cody Martin,SF,25,CHO,23,2,268,33,64,0.516,4,20,0.2,29,44,0.659,8,10,0.8,19,35,54,24,12,4,15,13,78
287,Kelan Martin,SF,25,IND,12,0,48,7,20,0.35,2,9,0.222,5,11,0.455,2,2,1.0,1,11,12,0,3,0,4,5,18
288,Kenyon Martin Jr.,SF,20,HOU,7,0,69,10,27,0.37,1,4,0.25,9,23,0.391,2,5,0.4,8,11,19,4,2,5,5,9,23
289,Frank Mason III, PG,26, ORL,4,1,79,9,24,0.375,2,5,0.4,7,19,0.368,5,7,0.7140000000000001,3,9,12,12,0,0,5,7,25
290,Garrison Mathews,SG,24,WAS,28,12,454,53,126,0.42100000000000004,40,100,0.4,13,26,0.5,46,50,0.92,11,38,49,13,20,5,4,46,192
291,Dakota Mathias,SG,25,PHI,8,2,123,19,48,0.396,8,26,0.308,11,22,0.5,2,6,0.33299999999999996,1,6,7,13,1,3,1,7,48
292,Wesley Matthews,SG,34,LAL,30,4,605,42,118,0.35600000000000004,31,92,0.337,11,26,0.423,12,15,0.8,12,32,44,34,15,11,15,43,127
293,Tyrese Maxey,SG,20,PHI,32,6,519,109,242,0.45,15,55,0.273,94,187,0.503,22,25,0.88,8,52,60,58,15,5,22,40,255
294,Skylar Mays,SG,23,ATL,16,0,132,19,49,0.38799999999999996,8,23,0.348,11,26,0.423,16,18,0.889,6,6,12,18,6,0,4,6,62
295,Patrick McCaw,SF,25,TOR,3,0,20,0,0,,0,0,,0,0,,0,0,,1,0,1,4,0,0,0,3,0
296,CJ McCollum,SG,29,POR,13,13,440,123,260,0.473,63,143,0.441,60,117,0.513,38,45,0.8440000000000001,7,44,51,65,17,4,13,28,347
297,T.J. McConnell,PG,28,IND,32,2,810,100,190,0.526,6,19,0.316,94,171,0.55,9,18,0.5,22,95,117,216,63,12,60,50,215
298,Jaden McDaniels,PF,20,MIN,30,1,574,57,149,0.38299999999999995,28,83,0.337,29,66,0.439,12,23,0.522,18,83,101,30,10,30,23,71,154
299,Jalen McDaniels,SF,23,CHO,17,1,213,29,66,0.439,6,23,0.261,23,43,0.535,13,19,0.684,8,37,45,8,2,4,14,30,77
300,Doug McDermott,PF,29,IND,34,14,882,174,344,0.506,55,151,0.364,119,193,0.617,45,55,0.818,34,101,135,45,11,3,33,59,448
301,Sean McDermott,SF,24,MEM,8,0,126,10,23,0.435,5,15,0.33299999999999996,5,8,0.625,6,6,1.0,4,8,12,4,1,2,4,6,31
302,JaVale McGee,C,33,CLE,27,1,411,85,174,0.489,5,17,0.294,80,157,0.51,28,46,0.609,42,97,139,26,13,33,36,69,203
303,Rodney McGruder,SG,29,DET,12,0,115,22,43,0.512,8,16,0.5,14,27,0.519,5,6,0.833,4,8,12,12,4,1,6,8,57
304,Alfonzo McKinnie,SF,28,LAL,18,0,84,16,30,0.5329999999999999,5,12,0.41700000000000004,11,18,0.611,5,8,0.625,7,13,20,1,2,0,1,7,42
305,Jordan McLaughlin,PG,24,MIN,24,0,467,53,141,0.376,16,46,0.348,37,95,0.389,8,10,0.8,13,43,56,113,24,4,26,24,130
306,Ben McLemore,SG,27,HOU,24,2,372,50,140,0.35700000000000004,32,102,0.314,18,38,0.474,17,23,0.7390000000000001,10,41,51,23,14,1,23,34,149
307,Nicolò Melli,PF,30,NOP,17,0,186,9,40,0.225,7,33,0.212,2,7,0.28600000000000003,4,5,0.8,3,35,38,16,8,1,7,22,29
308,De'Anthony Melton,PG,22,MEM,20,1,408,76,161,0.47200000000000003,33,78,0.423,43,83,0.518,16,21,0.762,10,52,62,58,24,14,25,34,201
309,Sam Merrill,SG,24,MIL,13,0,77,6,17,0.353,5,11,0.455,1,6,0.16699999999999998,2,2,1.0,4,10,14,11,2,0,3,6,19
310,Chimezie Metu,C,23,SAC,11,0,71,15,30,0.5,1,3,0.33299999999999996,14,27,0.519,6,9,0.667,11,12,23,5,3,6,6,10,37
311,Khris Middleton,SF,29,MIL,36,36,1203,272,549,0.495,83,192,0.43200000000000005,189,357,0.529,114,129,0.884,31,190,221,206,40,6,94,92,741
312,Darius Miller,SF,30,OKC,12,0,111,11,24,0.45799999999999996,9,21,0.429,2,3,0.667,3,3,1.0,1,14,15,10,5,4,5,9,34
313,Patty Mills,PG,32,SAS,32,0,824,151,337,0.44799999999999995,88,219,0.402,63,118,0.534,36,40,0.9,10,48,58,85,20,1,34,46,426
314,Paul Millsap,PF,35,DEN,26,26,621,99,189,0.524,32,78,0.41,67,111,0.604,41,59,0.695,41,93,134,43,22,14,26,54,271
315,Shake Milton,SG,24,PHI,28,1,703,135,306,0.441,31,99,0.313,104,207,0.502,86,97,0.887,17,43,60,85,18,7,43,64,387
316,Donovan Mitchell,SG,24,UTA,34,34,1154,288,684,0.42100000000000004,113,296,0.382,175,388,0.451,150,182,0.8240000000000001,37,122,159,183,33,10,101,77,839
317,Adam Mokoka,SG,22,CHI,7,0,42,5,14,0.35700000000000004,1,8,0.125,4,6,0.667,0,0,,1,3,4,4,2,1,2,5,11
318,Malik Monk,SG,22,CHO,22,0,499,103,223,0.462,54,123,0.439,49,100,0.49,37,47,0.787,8,55,63,41,6,2,33,32,297
319,E'Twaun Moore,SG,31,PHO,22,1,334,40,95,0.42100000000000004,6,25,0.24,34,70,0.486,8,10,0.8,11,28,39,35,14,4,18,30,94
320,Ja Morant,PG,21,MEM,24,24,738,172,379,0.45399999999999996,21,90,0.233,151,289,0.522,110,138,0.797,20,59,79,184,25,4,69,36,475
321,Juwan Morgan,PF,23,UTA,15,0,71,6,14,0.429,3,10,0.3,3,4,0.75,1,5,0.2,4,10,14,4,3,0,2,12,16
322,Marcus Morris,PF,31,LAC,28,2,684,121,275,0.44,65,140,0.46399999999999997,56,135,0.415,38,42,0.905,20,86,106,25,15,8,25,52,345
323,Markieff Morris,PF,31,LAL,31,7,539,59,145,0.40700000000000003,28,87,0.322,31,58,0.534,20,29,0.69,22,95,117,31,7,8,18,50,166
324,Monte Morris,PG,25,DEN,35,9,949,142,298,0.47700000000000004,40,111,0.36,102,187,0.545,46,61,0.754,7,69,76,118,24,10,24,33,370
325,Mychal Mulder,PG,26,GSW,34,2,360,47,108,0.435,38,93,0.409,9,15,0.6,8,15,0.5329999999999999,1,30,31,15,8,7,8,27,140
326,Dejounte Murray,PG,24,SAS,32,32,992,207,454,0.456,34,105,0.324,173,349,0.496,56,69,0.812,19,206,225,172,52,3,53,67,504
327,Jamal Murray,PG,23,DEN,34,34,1204,273,561,0.48700000000000004,90,226,0.39799999999999996,183,335,0.546,104,123,0.846,24,118,142,156,39,11,78,73,740
328,Mike Muscala,C,29,OKC,34,0,633,116,263,0.441,67,182,0.368,49,81,0.605,32,35,0.914,19,110,129,27,8,11,21,53,331
329,Sviatoslav Mykhailiuk,SF,23,DET,35,4,608,80,212,0.377,54,161,0.335,26,51,0.51,24,30,0.8,11,59,70,49,25,6,38,31,238
330,Abdel Nader,SF,27,PHO,19,0,273,44,90,0.489,13,33,0.39399999999999996,31,57,0.544,20,25,0.8,3,43,46,15,6,7,13,24,121
331,Larry Nance Jr.,PF,28,CLE,19,18,635,70,145,0.483,24,63,0.381,46,82,0.561,12,21,0.5710000000000001,27,102,129,61,37,10,28,41,176
332,Aaron Nesmith,SF,21,BOS,18,0,281,25,63,0.397,17,48,0.354,8,15,0.5329999999999999,8,12,0.667,10,34,44,7,3,5,11,37,75
333,Raul Neto,PG,28,WAS,29,6,591,88,196,0.449,28,75,0.373,60,121,0.496,25,30,0.833,13,53,66,60,33,2,21,39,229
334,Georges Niang,PF,27,UTA,36,0,481,72,167,0.431,45,117,0.385,27,50,0.54,5,5,1.0,12,66,78,24,11,3,23,55,194
335,Zeke Nnaji,PF,20,DEN,23,1,248,31,61,0.508,15,36,0.41700000000000004,16,25,0.64,5,7,0.7140000000000001,10,23,33,3,3,2,5,16,82
336,Nerlens Noel,C,26,NYK,32,10,710,68,111,0.613,0,2,0.0,68,109,0.624,22,33,0.667,68,127,195,20,32,65,37,83,158
337,Jaylen Nowell,SG,21,MIN,22,0,367,71,170,0.418,25,72,0.34700000000000003,46,98,0.469,31,37,0.838,10,32,42,23,10,4,12,40,198
338,Frank Ntilikina,PG,22,NYK,9,1,127,18,37,0.486,13,21,0.619,5,16,0.313,3,5,0.6,1,6,7,7,8,0,5,15,52
339,Kendrick Nunn,PG,25,MIA,28,16,839,152,330,0.461,58,159,0.365,94,171,0.55,36,39,0.9229999999999999,14,80,94,76,32,9,50,54,398
340,Jusuf Nurkić,C,26,POR,12,12,280,50,103,0.485,3,12,0.25,47,91,0.516,15,27,0.556,23,69,92,33,11,11,23,33,118
341,David Nwaba,SF,28,HOU,28,9,642,100,208,0.48100000000000004,17,63,0.27,83,145,0.5720000000000001,46,66,0.6970000000000001,37,66,103,28,30,20,17,58,263
342,Jordan Nwora,SF,22,MIL,10,0,82,17,37,0.45899999999999996,8,16,0.5,9,21,0.429,9,10,0.9,1,14,15,0,4,2,10,9,51
343,Royce O'Neale,SF,27,UTA,36,36,1181,94,213,0.441,62,151,0.41100000000000003,32,62,0.516,23,28,0.821,45,199,244,94,28,20,42,102,273
344,Semi Ojeleye,PF,26,BOS,34,6,645,63,151,0.41700000000000004,41,107,0.38299999999999995,22,44,0.5,20,28,0.7140000000000001,20,78,98,27,11,0,14,41,187
345,Jahlil Okafor,C,25,DET,12,0,120,25,42,0.595,0,3,0.0,25,39,0.6409999999999999,1,2,0.5,13,14,27,3,2,2,4,10,51
346,Chuma Okeke,PF,22,ORL,20,0,437,33,86,0.384,17,44,0.386,16,42,0.381,5,10,0.5,18,52,70,39,16,7,13,19,88
347,Josh Okogie,SG,22,MIN,29,20,558,47,134,0.35100000000000003,12,55,0.218,35,79,0.44299999999999995,31,41,0.7559999999999999,26,47,73,30,24,14,22,58,137
348,Onyeka Okongwu,C,20,ATL,16,1,159,21,37,0.568,0,1,0.0,21,36,0.583,9,15,0.6,12,27,39,5,6,7,8,26,51
349,Isaac Okoro,SG,20,CLE,31,31,1030,93,225,0.413,28,93,0.301,65,132,0.49200000000000005,36,53,0.679,30,53,83,58,36,16,46,95,250
350,KZ Okpala,PF,21,MIA,19,6,199,14,40,0.35,8,24,0.33299999999999996,6,16,0.375,2,6,0.33299999999999996,8,21,29,7,3,4,9,24,38
351,Victor Oladipo,SG,28,TOT,24,24,786,174,436,0.39899999999999997,60,181,0.331,114,255,0.447,71,95,0.747,8,117,125,109,36,11,53,56,479
351,Victor Oladipo,SG,28,IND,9,9,300,64,152,0.42100000000000004,25,69,0.36200000000000004,39,83,0.47,27,37,0.73,1,50,51,38,15,2,18,23,180
351,Victor Oladipo,SG,28,HOU,15,15,486,110,284,0.387,35,112,0.313,75,172,0.436,44,58,0.759,7,67,74,71,21,9,35,33,299
352,Kelly Olynyk,C,29,MIA,35,30,927,132,299,0.441,66,201,0.32799999999999996,66,98,0.6729999999999999,22,30,0.733,32,173,205,75,28,19,46,98,352
353,Miye Oni,SG,23,UTA,26,0,206,14,38,0.368,13,33,0.39399999999999996,1,5,0.2,5,6,0.833,14,32,46,6,3,4,7,29,46
354,Cedi Osman,SF,25,CLE,35,15,904,136,365,0.373,70,211,0.332,66,154,0.429,39,49,0.7959999999999999,24,104,128,93,30,4,37,71,381
355,Daniel Oturu,C,21,LAC,10,0,42,9,15,0.6,0,1,0.0,9,14,0.643,2,2,1.0,5,9,14,4,0,3,2,6,20
356,Kelly Oubre Jr.,SF,25,GSW,35,35,1062,202,463,0.436,60,187,0.321,142,276,0.514,77,104,0.74,51,157,208,49,39,27,45,77,541
357,Jabari Parker,PF,25,SAC,2,0,25,4,7,0.5710000000000001,0,1,0.0,4,6,0.667,0,0,,1,5,6,1,0,1,3,4,8
358,Eric Paschall,PF,24,GSW,34,2,599,131,265,0.494,13,45,0.289,118,220,0.536,61,85,0.718,26,86,112,43,9,4,35,57,336
359,Anžejs Pasečņiks,C,25,WAS,1,0,6,0,1,0.0,0,1,0.0,0,0,,0,0,,1,0,1,1,0,0,5,2,0
360,Patrick Patterson,PF,31,LAC,10,1,130,16,38,0.42100000000000004,10,28,0.35700000000000004,6,10,0.6,3,4,0.75,4,16,20,5,3,1,7,13,45
361,Justin Patton,C,23,HOU,6,2,128,16,31,0.516,6,17,0.353,10,14,0.7140000000000001,3,4,0.75,5,19,24,5,7,10,2,19,41
362,Chris Paul,PG,35,PHO,34,34,1080,204,420,0.486,52,133,0.391,152,287,0.53,83,87,0.9540000000000001,16,144,160,300,40,10,81,84,543
363,Cameron Payne,PG,26,PHO,24,0,394,61,127,0.48,24,57,0.42100000000000004,37,70,0.529,13,14,0.929,3,41,44,86,15,5,25,42,159
364,Elfrid Payton,PG,26,NYK,33,33,932,174,393,0.44299999999999995,15,60,0.25,159,333,0.47700000000000004,55,74,0.743,42,83,125,122,23,7,62,64,418
365,Norvel Pelle,C,27,TOT,4,0,32,3,8,0.375,0,0,,3,8,0.375,3,4,0.75,4,4,8,1,0,3,3,10,9
365,Norvel Pelle,C,27,BRK,3,0,28,3,7,0.429,0,0,,3,7,0.429,0,0,,3,4,7,0,0,3,3,9,6
365,Norvel Pelle,C,27,SAC,1,0,4,0,1,0.0,0,0,,0,1,0.0,3,4,0.75,1,0,1,1,0,0,0,1,3
366,Reggie Perry,PF,20,BRK,14,0,147,21,51,0.41200000000000003,2,12,0.16699999999999998,19,39,0.48700000000000004,6,9,0.667,17,34,51,12,2,5,11,27,50
367,Theo Pinson,SG,25,NYK,11,0,25,1,7,0.14300000000000002,0,6,0.0,1,1,1.0,0,0,,0,1,1,1,0,0,0,3,2
368,Mason Plumlee,C,30,DET,34,34,953,145,239,0.607,0,6,0.0,145,233,0.622,64,95,0.674,94,217,311,130,28,29,72,120,354
369,Jakob Poeltl,C,25,SAS,32,14,750,97,159,0.61,0,0,,97,159,0.61,15,47,0.319,95,139,234,58,20,50,37,70,209
370,Vincent Poirier,C,27,PHI,6,0,22,1,4,0.25,0,0,,1,4,0.25,2,4,0.5,2,2,4,1,0,2,2,2,4
371,Aleksej Pokusevski,PF,19,OKC,17,0,296,23,93,0.247,10,56,0.179,13,37,0.35100000000000003,0,0,,5,55,60,21,8,19,22,16,56
372,Jordan Poole,SG,21,GSW,16,0,170,36,77,0.46799999999999997,18,49,0.36700000000000005,18,28,0.643,19,20,0.95,2,19,21,14,4,3,8,14,109
373,Michael Porter Jr.,SF,22,DEN,26,19,744,142,283,0.502,62,149,0.41600000000000004,80,134,0.597,34,45,0.7559999999999999,32,151,183,23,23,28,29,60,380
374,Otto Porter,SF,27,CHI,16,6,372,64,144,0.444,28,70,0.4,36,74,0.486,30,36,0.833,20,80,100,32,9,3,15,25,186
375,Bobby Portis,C,25,MIL,36,2,776,166,304,0.546,38,76,0.5,128,228,0.561,23,33,0.6970000000000001,67,188,255,37,30,15,28,70,393
376,Kristaps Porziņģis,C,25,DAL,20,20,602,151,322,0.469,44,126,0.349,107,196,0.546,57,68,0.838,37,130,167,27,8,31,25,59,403
377,Dwight Powell,C,29,DAL,23,8,346,31,67,0.46299999999999997,1,8,0.125,30,59,0.508,43,57,0.754,23,50,73,20,13,7,16,53,106
378,Norman Powell,SG,27,TOR,34,23,1006,211,432,0.488,88,201,0.43799999999999994,123,231,0.532,116,129,0.899,15,87,102,59,40,5,59,73,626
379,Taurean Prince,PF,26,TOT,29,10,620,79,208,0.38,39,101,0.386,40,107,0.374,45,53,0.8490000000000001,15,89,104,50,19,19,31,53,242
379,Taurean Prince,PF,26,BRK,12,4,218,30,74,0.405,13,37,0.35100000000000003,17,37,0.45899999999999996,24,27,0.889,2,32,34,7,8,8,11,21,97
379,Taurean Prince,PF,26,CLE,17,6,402,49,134,0.366,26,64,0.406,23,70,0.32899999999999996,21,26,0.8079999999999999,13,57,70,43,11,11,20,32,145
380,Payton Pritchard,SG,23,BOS,30,1,641,86,188,0.457,41,102,0.402,45,86,0.523,17,18,0.9440000000000001,16,54,70,69,18,5,34,59,230
381,Immanuel Quickley,PG,21,NYK,33,0,619,123,316,0.389,59,155,0.381,64,161,0.39799999999999996,98,104,0.9420000000000001,15,62,77,79,15,9,34,64,403
382,Jahmi'us Ramsey,SG,19,SAC,4,0,16,2,4,0.5,1,3,0.33299999999999996,1,1,1.0,0,0,,0,4,4,1,0,1,1,0,5
383,Chasson Randle,PG,27,ORL,8,0,151,15,35,0.429,7,23,0.304,8,12,0.667,5,7,0.7140000000000001,1,14,15,23,2,1,6,18,42
384,Julius Randle,PF,26,NYK,37,37,1358,307,636,0.483,69,169,0.408,238,467,0.51,177,220,0.805,52,357,409,205,29,9,120,115,860
385,Cam Reddish,SF,21,ATL,26,21,750,96,263,0.365,33,126,0.262,63,137,0.46,67,82,0.8170000000000001,22,82,104,35,33,9,34,68,292
386,J.J. Redick,SG,36,NOP,31,0,576,87,214,0.40700000000000003,51,140,0.364,36,74,0.486,45,47,0.9570000000000001,3,49,52,40,9,2,25,37,270
387,Paul Reed,PF,21,PHI,5,0,55,9,22,0.409,0,3,0.0,9,19,0.474,0,0,,7,3,10,3,1,4,5,4,18
388,Naz Reid,C,21,MIN,34,13,699,158,307,0.515,32,94,0.34,126,213,0.5920000000000001,55,75,0.733,39,123,162,44,21,41,38,104,403
389,Nick Richards,PF,23,CHO,8,0,23,3,6,0.5,0,0,,3,6,0.5,5,6,0.833,2,4,6,0,0,0,1,4,11
390,Josh Richardson,SG,27,DAL,25,25,788,114,267,0.42700000000000005,38,132,0.28800000000000003,76,135,0.563,55,58,0.948,22,60,82,63,23,6,37,70,321
391,Austin Rivers,SG,28,NYK,21,2,442,58,135,0.43,28,77,0.364,30,58,0.517,10,14,0.7140000000000001,5,42,47,42,12,0,22,32,154
392,Andre Roberson,SG,29,BRK,5,0,63,2,14,0.14300000000000002,1,8,0.125,1,6,0.16699999999999998,1,2,0.5,7,8,15,4,3,1,2,4,6
393,Duncan Robinson,SF,26,MIA,36,36,1202,151,352,0.429,117,299,0.391,34,53,0.642,42,50,0.84,2,140,142,58,17,8,48,90,461
394,Glenn Robinson III,SF,27,SAC,23,2,369,42,99,0.424,16,44,0.364,26,55,0.473,21,23,0.9129999999999999,11,34,45,20,4,3,11,23,121
395,Jerome Robinson,SG,23,WAS,13,3,221,22,67,0.32799999999999996,9,31,0.29,13,36,0.361,15,17,0.882,2,31,33,18,6,2,11,21,68
396,Mitchell Robinson,C,22,NYK,27,27,778,103,156,0.66,0,0,,103,156,0.66,22,46,0.478,97,129,226,14,32,41,22,78,228
397,Isaiah Roby,PF,22,OKC,30,12,640,99,190,0.521,18,53,0.34,81,137,0.591,42,58,0.7240000000000001,46,117,163,53,25,17,40,82,258
398,Rajon Rondo,PG,34,ATL,20,2,300,29,74,0.392,13,34,0.382,16,40,0.4,1,2,0.5,4,40,44,70,12,2,27,18,72
399,Derrick Rose,PG,32,TOT,25,3,588,126,293,0.43,23,61,0.377,103,232,0.444,63,74,0.851,7,48,55,112,29,10,48,29,338
399,Derrick Rose,PG,32,DET,15,0,342,79,184,0.429,13,39,0.33299999999999996,66,145,0.455,42,50,0.84,6,23,29,63,18,4,29,17,213
399,Derrick Rose,PG,32,NYK,10,3,246,47,109,0.431,10,22,0.455,37,87,0.425,21,24,0.875,1,25,26,49,11,6,19,12,125
400,Terrence Ross,SG,29,ORL,35,2,1032,195,476,0.41,73,212,0.344,122,264,0.462,81,90,0.9,12,110,122,78,39,17,58,64,544
401,Terry Rozier,SG,26,CHO,33,33,1106,245,500,0.49,111,253,0.439,134,247,0.5429999999999999,75,91,0.8240000000000001,18,109,127,106,46,12,68,65,676
402,Ricky Rubio,PG,30,MIN,34,19,863,92,236,0.39,27,82,0.32899999999999996,65,154,0.42200000000000004,61,74,0.8240000000000001,14,93,107,218,42,0,70,77,272
403,D'Angelo Russell,PG,24,MIN,20,19,583,139,326,0.426,59,148,0.39899999999999997,80,178,0.449,48,64,0.75,9,43,52,101,22,10,54,39,385
404,Domantas Sabonis,PF,24,IND,35,35,1278,274,522,0.525,32,96,0.33299999999999996,242,426,0.568,147,206,0.7140000000000001,91,298,389,211,36,21,119,120,727
405,Luka Šamanić,PF,21,SAS,9,1,99,15,34,0.441,8,20,0.4,7,14,0.5,4,8,0.5,6,22,28,1,3,2,6,10,42
406,JaKarr Sampson,PF,27,IND,15,0,97,15,32,0.469,1,5,0.2,14,27,0.519,8,10,0.8,8,21,29,1,2,3,6,11,39
407,Dario Šarić,C,26,PHO,17,0,307,69,143,0.483,23,61,0.377,46,82,0.561,34,37,0.919,14,54,68,22,14,3,21,33,195
408,Tomáš Satoranský,SG,29,CHI,23,0,476,60,112,0.536,19,39,0.48700000000000004,41,73,0.562,26,29,0.897,8,52,60,102,12,4,34,27,165
409,Dennis Schröder,SG,27,LAL,33,33,1030,173,393,0.44,33,104,0.317,140,289,0.484,113,136,0.831,18,97,115,148,30,8,77,88,492
410,Mike Scott,PF,32,PHI,17,4,295,26,63,0.413,19,50,0.38,7,13,0.5379999999999999,2,5,0.4,4,43,47,5,8,2,10,17,73
411,Collin Sexton,SG ,22,CLE ,31,31,1127,274,563,0.48700000000000004,52,130,0.4,222,433,0.513,147,183,0.8029999999999999,21,60,81,138,36,4,91,88,747
412,Landry Shamet,SG,23,BRK,33,0,650,83,216,0.384,58,162,0.358,25,54,0.46299999999999997,33,38,0.868,5,56,61,37,15,5,26,42,257
413,Iman Shumpert,SG,30,BRK,2,0,11,1,4,0.25,0,3,0.0,1,1,1.0,0,0,,1,0,1,0,1,0,1,0,2
414,Pascal Siakam,PF,26,TOR,30,30,1075,222,490,0.45299999999999996,36,122,0.295,186,368,0.505,122,149,0.8190000000000001,58,166,224,143,35,21,65,93,602
415,Chris Silva,PF,24,MIA,6,0,53,6,9,0.667,1,1,1.0,5,8,0.625,10,12,0.833,7,11,18,6,1,2,8,14,23
416,Ben Simmons,PG,24,PHI,31,31,1051,192,332,0.578,2,7,0.28600000000000003,190,325,0.585,112,167,0.6709999999999999,54,191,245,236,49,22,104,96,498
417,Anfernee Simons,SG,21,POR,32,0,543,87,220,0.395,65,158,0.41100000000000003,22,62,0.355,22,26,0.846,6,72,78,41,6,5,27,55,261
418,Deividas Sirvydis,SG,20,DET,5,0,8,0,3,0.0,0,3,0.0,0,0,,1,2,0.5,0,1,1,1,0,0,0,1,1
419,Marcus Smart,PG,26,BOS,17,17,549,74,188,0.39399999999999996,28,90,0.311,46,98,0.469,46,62,0.742,7,40,47,103,31,9,30,39,222
420,Dennis Smith Jr.,PG,23,TOT,15,7,275,42,109,0.385,14,44,0.318,28,65,0.431,11,14,0.7859999999999999,10,30,40,49,18,8,17,23,109
420,Dennis Smith Jr.,pg,23,NYK,3,0,28,2,10,0.2,0,4,0.0,2,6,0.33299999999999996,5,6,0.833,0,2,2,3,3,0,1,4,9
420,Dennis Smith Jr.,PG,23,DET,12,7,247,40,99,0.40399999999999997,14,40,0.35,26,59,0.441,6,8,0.75,10,28,38,46,15,8,16,19,100
421,Ish Smith,PG,32,WAS,19,1,391,44,116,0.379,5,20,0.25,39,96,0.406,6,15,0.4,10,56,66,90,15,4,19,18,99
422,Jalen Smith,PF,20,PHO,11,0,57,7,19,0.368,2,8,0.25,5,11,0.455,0,2,0.0,5,6,11,2,0,2,1,4,16
423,Tony Snell,SG,29,ATL,23,6,420,41,85,0.48200000000000004,35,62,0.565,6,23,0.261,0,0,,11,36,47,27,3,7,13,31,117
424,Ray Spalding,C,23,HOU,2,0,19,2,4,0.5,0,1,0.0,2,3,0.667,0,2,0.0,2,2,4,0,0,2,3,3,4
425,Cassius Stanley,SG,21,IND,8,0,23,2,7,0.28600000000000003,1,2,0.5,1,5,0.2,4,5,0.8,2,1,3,0,0,2,1,7,9
426,Lamar Stevens,PF,23,CLE,24,0,346,38,94,0.40399999999999997,2,17,0.11800000000000001,36,77,0.46799999999999997,23,32,0.7190000000000001,12,51,63,23,11,8,15,35,101
427,Isaiah Stewart,C,19,DET,34,2,626,81,146,0.555,1,5,0.2,80,141,0.5670000000000001,22,32,0.688,80,116,196,24,18,34,30,88,185
428,Max Strus,SF,24,MIA,19,0,283,47,103,0.456,31,85,0.365,16,18,0.889,10,14,0.7140000000000001,2,18,20,10,3,0,3,24,135
429,Edmond Sumner,SG,25,IND,22,4,251,42,82,0.512,9,26,0.34600000000000003,33,56,0.589,20,27,0.741,8,23,31,10,13,2,17,26,113
430,Jae'Sean Tate,SF,25,H0U,34,22,933,135,252,0.536,22,69,0.319,113,183,0.617,43,57,0.754,64,115,179,57,32,18,40,104,335
431,Jayson Tatum,SF,22,BOS,31,31,1110,279,638,0.43700000000000006,81,220,0.368,198,418,0.474,134,156,0.8590000000000001,18,201,219,138,42,15,79,60,773
432,Jeff Teague,PG,32,BOS,28,4,506,59,158,0.373,19,45,0.42200000000000004,40,113,0.354,43,48,0.8959999999999999,7,39,46,59,23,5,32,34,180
433,Garrett Temple,SG,34,CHI,33,12,936,107,250,0.428,45,131,0.344,62,119,0.521,31,38,0.816,20,87,107,68,31,18,33,77,290
434,Tyrell Terry,PG,20,DAL,11,0,56,5,16,0.313,0,7,0.0,5,9,0.556,1,3,0.33299999999999996,0,6,6,6,5,0,2,2,11
435,Daniel Theis,C,28,BOS,34,29,827,124,220,0.564,27,73,0.37,97,147,0.66,40,60,0.667,43,127,170,46,21,38,35,98,315
436,Brodric Thomas,SG,24,HOU,4,0,24,2,7,0.28600000000000003,1,6,0.16699999999999998,1,1,1.0,5,7,0.7140000000000001,1,3,4,4,1,1,4,5,10
437,Matt Thomas,SG,26,TOR,21,0,145,18,46,0.391,12,31,0.387,6,15,0.4,5,6,0.833,1,13,14,9,2,0,5,8,53
438,Tristan Thompson,PF,29,BOS,34,29,774,111,209,0.531,0,3,0.0,111,206,0.539,48,76,0.632,105,178,283,33,12,13,31,72,270
439,Sindarius Thornwell,SG,26,NOP,11,1,53,6,13,0.462,3,6,0.5,3,7,0.429,0,2,0.0,1,2,3,2,4,0,2,3,15
440,Matisse Thybulle,SG,23,PHI,33,2,596,39,106,0.368,17,65,0.262,22,41,0.537,8,14,0.5710000000000001,12,36,48,31,46,30,13,66,103
441,Killian Tillie,C,22,MEM,2,0,21,1,4,0.25,1,2,0.5,0,2,0.0,0,0,,1,1,2,0,1,0,1,5,3
442,Xavier Tillman Sr.,PF,22,MEM,27,7,551,81,158,0.513,10,35,0.28600000000000003,71,123,0.5770000000000001,17,23,0.7390000000000001,40,85,125,45,25,16,24,64,189
443,Obi Toppin,PF,22,NyK,27,0,342,52,107,0.486,13,44,0.295,39,63,0.619,10,14,0.7140000000000001,9,58,67,15,8,10,15,28,127
444,Juan Toscano-Anderson,SG,27,GSW,23,13,474,53,94,0.564,15,35,0.429,38,59,0.644,13,18,0.722,16,87,103,51,13,12,26,48,134
445,Karl-Anthony Towns,C,25,MIN,16,16,524,126,255,0.494,30,80,0.375,96,175,0.5489999999999999,70,77,0.909,48,127,175,63,14,27,51,60,352
446,Gary Trent Jr.,SG,22,POR,33,20,1030,183,433,0.423,101,249,0.406,82,184,0.446,35,45,0.778,19,52,71,49,25,5,24,53,502
447,P.J. Tucker,PF,35,HOU,32,32,959,48,131,0.366,27,86,0.314,21,45,0.467,18,23,0.7829999999999999,33,115,148,45,29,18,33,91,141
448,Myles Turner,C,24, IND,33,33,1038,156,322,0.484,48,153,0.314,108,169,0.639,84,108,0.778,45,171,216,30,34,111,45,117,444
449,Jonas Valančiūnas,C,28, MEM,27,26,733,171,317,0.539,10,28,0.35700000000000004,161,289,0.557,68,90,0.7559999999999999,93,213,306,47,16,17,56,83,420
450,Denzel Valentine,SG,27,CHI,30,3,591,93,248,0.375,49,141,0.348,44,107,0.41100000000000003,6,6,1.0,12,110,122,54,22,1,18,36,241
451,Jarred Vanderbilt,PF,21,MIN,34,17,652,85,139,0.612,1,2,0.5,84,137,0.613,35,63,0.556,62,133,195,52,38,22,35,73,206
452,Fred VanVleet,SG,26,TOR,34,34,1249,226,565,0.4,114,298,0.38299999999999995,112,267,0.419,118,132,0.894,23,128,151,224,58,27,69,83,684
453,Devin Vassell,SF,20,SAS,26,1,451,50,126,0.397,25,63,0.397,25,63,0.397,18,21,0.857,16,67,83,28,29,9,12,32,143
454,Gabe Vincent,PG,24,MIA ,25,5,375,52,143,0.364,23,89,0.258,29,54,0.537,19,21,0.905,3,24,27,31,12,2,20,46,146
455,Noah Vonleh,PF,25,BRK,4,0,11,0,3,0.0,0,2,0.0,0,1,0.0,0,0,,0,1,1,1,0,0,2,2,0
456,Nikola Vučević,C,30,ORL,36,36,1220,355,735,0.483,96,233,0.41200000000000003,259,502,0.516,80,94,0.851,69,348,417,134,36,23,60,62,886
457,Dean Wade,PF,24,CLE,28,5,320,33,74,0.446,22,52,0.423,11,22,0.5,8,12,0.667,13,47,60,18,6,5,12,23,96
458,Moritz Wagner,C,23, WAS,22,11,315,56,105,0.5329999999999999,12,35,0.34299999999999997,44,70,0.629,33,44,0.75,11,55,66,26,16,6,14,50,157
459,Kemba Walker,PG,30,BOS,20,20,600,123,317,0.38799999999999996,59,161,0.366,64,156,0.41,64,70,0.914,8,64,72,91,21,7,44,27,369
460,Lonnie Walker,SG,22,SAS,30,27,819,127,316,0.402,53,148,0.358,74,168,0.44,32,40,0.8,6,80,86,53,15,13,32,64,339
461,John Wall,PG,30,HOU,25,25,793,188,443,0.424,51,150,0.34,137,293,0.46799999999999997,99,133,0.7440000000000001,11,70,81,151,22,18,83,29,526
462,Brad Wanamaker,PG,31,GSW,37,0,599,58,162,0.358,13,56,0.23199999999999998,45,106,0.425,49,55,0.8909999999999999,8,54,62,99,26,6,35,51,178
463,T.J. Warren,SF,27,IND ,4,4,117,27,51,0.529,0,7,0.0,27,44,0.614,8,10,0.8,2,12,14,5,2,0,4,16,62
464,P.J. Washington,PF,22,CHO,31,31,910,137,305,0.449,42,109,0.385,95,196,0.485,70,90,0.778,45,151,196,90,34,36,65,83,386
465,Yuta Watanabe,SF,26,TOR,22,1,268,20,60,0.33299999999999996,12,33,0.364,8,27,0.29600000000000004,8,8,1.0,18,53,71,8,9,12,8,23,60
466,Tremont Waters,PG,23, BOS,10,1,98,10,31,0.32299999999999995,6,15,0.4,4,16,0.25,7,8,0.875,2,6,8,30,6,0,13,6,33
467,Paul Watson,SF,26,TOR,16,0,74,10,20,0.5,9,17,0.529,1,3,0.33299999999999996,0,0,,2,12,14,2,0,2,1,9,29
468,Quinndary Weatherspoon,SG,24,SAS,5,0,24,1,5,0.2,0,1,0.0,1,4,0.25,2,2,1.0,0,2,2,3,1,0,6,7,4
469,Russell Westbrook, PG,32,WAS,27,27,923,211,493,0.428,30,102,0.294,181,391,0.46299999999999997,95,163,0.583,44,219,263,265,31,9,130,79,547
470,Coby White,PG,20,CHI,34,34,1130,201,479,0.42,81,229,0.354,120,250,0.48,69,77,0.8959999999999999,17,155,172,171,12,5,80,86,552
471,Derrick White,SG,26,SAS,8,4,189,34,86,0.395,15,44,0.341,19,42,0.452,11,15,0.733,1,13,14,31,8,8,7,18,94
472,Hassan Whiteside,C,31,SAC,23,1,335,80,138,0.58,0,1,0.0,80,137,0.584,30,55,0.545,36,96,132,11,6,30,24,42,190
473,Greg Whittington,PF,27,DEN,2,0,8,0,2,0.0,0,2,0.0,0,0,,0,0,,0,0,0,0,0,0,0,0,0
474,Andrew Wiggins,PF,25,GSW ,37,37,1193,241,521,0.46299999999999997,65,185,0.35100000000000003,176,336,0.524,82,122,0.672,38,127,165,81,30,40,69,85,629
475,Grant Williams,PF,22,BOS,28,6,517,54,115,0.47,26,60,0.433,28,55,0.509,15,29,0.517,27,54,81,25,13,11,27,79,149
476,Kenrich Williams,PF,26,OKC,36,6,681,93,168,0.5539999999999999,21,50,0.42,72,118,0.61,15,24,0.625,48,97,145,59,28,7,33,64,222
477,Lou Williams,PG,34,LAC,35,3,794,158,374,0.42200000000000004,39,98,0.39799999999999996,119,276,0.431,83,96,0.865,14,67,81,130,30,3,57,34,438
478,Patrick Williams,PF,19,CHI,33,33,939,127,268,0.474,30,77,0.39,97,191,0.508,52,66,0.7879999999999999,30,129,159,39,24,25,49,75,336
479,Robert Williams,C,23,BOS,29,0,468,88,122,0.721,0,1,0.0,88,121,0.727,25,39,0.6409999999999999,66,104,170,31,26,42,28,53,201
480,Zion Williamson,PF,20,NOP,34,34,1126,335,546,0.614,6,19,0.316,329,527,0.624,194,279,0.695,93,152,245,117,32,24,88,82,870
481,D.J. Wilson,PF,24,MIL,11,0,99,15,41,0.366,9,26,0.34600000000000003,6,15,0.4,1,2,0.5,3,20,23,3,1,4,4,12,40
482,Dylan Windler,SF,24,CLE,22,0,417,47,103,0.456,23,63,0.365,24,40,0.6,21,26,0.8079999999999999,17,73,90,28,15,10,22,29,138
483,Justise Winslow, SF,24,MEM ,6,0,134,24,64,0.375,3,15,0.2,21,49,0.429,6,10,0.6,5,26,31,9,3,4,10,18,57
484,Cassius Winston,Pg,22,WAS,6,0,44,4,10,0.4,3,7,0.429,1,3,0.33299999999999996,2,2,1.0,0,4,4,6,0,1,1,4,13
485,James Wiseman,C ,19,GSW,26,17,541,126,247,0.51,10,27,0.37,116,220,0.527,44,70,0.629,36,118,154,17,9,28,38,84,306
486,Christian Wood,C,25,HOU,17,17,530,149,267,0.5579999999999999,32,76,0.42100000000000004,117,191,0.613,44,64,0.688,31,143,174,22,16,26,31,32,374
487,Robert Woodard,SF,21,SAC,6,0,17,6,11,0.545,1,3,0.33299999999999996,5,8,0.625,0,2,0.0,3,5,8,0,0,0,1,0,13
488,Delon Wright,SG,28,DET,29,24,848,110,235,0.46799999999999997,28,73,0.384,82,162,0.506,62,79,0.785,32,101,133,141,42,15,35,32,310
489,Thaddeus Young,PF,32,CHI,30,0,760,167,274,0.609,5,22,0.22699999999999998,162,252,0.643,23,46,0.5,71,105,176,131,42,17,56,81,362
490,Trae Young,PG,22,ATL,34,34,1182,262,610,0.43,85,225,0.37799999999999995,177,385,0.46,288,328,0.878,25,117,142,321,30,8,149,70,897
491,Cody Zeller,C,28,CHO,18,15,421,73,142,0.514,3,19,0.158,70,123,0.569,25,33,0.758,46,90,136,44,11,11,20,47,174
492,Ivica Zubac,C,23,LAC,38,1,753,120,182,0.659,0,1,0.0,120,181,0.6629999999999999,71,86,0.826,90,176,266,43,14,30,39,228,311
